5 5 4 5 5 5 5 5 5 4 5 5 20 21 22 5 5 5 4 5 5 5 5 5 5 9 5 5 4 5 5 4 4 4 5 4 5 4 5 5 4 4 5 5 5 5 5 4 5 4 
4 9 9 9 9 7 9 9 0 1 0 9 20 21 22 9 9 9 9 9 9 9 9 4 9 8 6 4 9 9 7 9 9 9 9 9 9 9 9 9 9 9 9 9 9 8 2 2 2 5 
5 9 9 9 9 9 9 9 9 9 9 8 20 21 22 4 9 5 5 4 5 4 9 5 9 9 9 5 9 5 5 5 9 9 7 9 14 15 15 15 19 9 9 9 9 7 7 2 2 4 
4 9 7 9 6 6 9 7 12 11 13 9 20 21 22 4 1 5 9 5 2 5 9 4 6 9 8 5 9 4 6 9 9 9 14 15 18 21 21 21 17 15 19 9 9 9 9 9 9 4 
5 9 4 4 6 9 9 9 12 11 13 6 20 21 22 5 5 4 9 9 9 4 9 5 5 9 5 5 9 5 9 9 9 9 20 26 24 24 24 16 21 21 17 15 19 6 9 9 8 4 
5 9 4 9 9 9 9 9 9 8 7 9 20 21 22 9 9 9 7 4 5 5 9 9 8 9 5 2 9 5 9 6 9 14 18 22 9 9 9 23 24 24 16 21 22 9 9 9 9 5 
5 9 4 9 9 9 9 9 12 11 13 9 20 21 22 9 9 5 9 5 9 5 4 5 5 9 5 5 4 4 9 9 9 20 21 22 9 9 9 6 6 9 23 16 17 19 9 9 9 5 
5 9 5 5 5 5 5 7 9 7 7 9 20 21 22 5 5 5 9 5 9 9 9 9 9 9 9 8 9 5 7 9 9 20 21 22 9 9 6 9 6 6 9 20 21 22 9 9 9 5 
5 9 9 9 6 9 5 7 9 9 3 9 20 21 22 9 1 5 9 5 9 4 5 4 5 9 5 5 5 5 9 9 9 23 16 17 15 15 15 19 6 6 9 20 21 22 8 9 9 5 
5 9 4 4 5 9 5 5 5 9 0 3 20 21 22 9 9 9 9 9 9 5 9 9 9 6 9 9 9 5 9 9 6 9 23 24 24 24 24 25 9 9 8 20 21 22 9 9 9 5 
4 9 5 9 5 9 5 9 5 9 5 5 23 24 25 5 5 5 5 4 5 4 9 5 9 6 5 5 8 5 9 8 7 7 9 9 9 7 7 9 7 9 9 20 21 22 9 9 9 5 
5 9 5 9 5 9 5 9 5 9 5 9 6 6 9 9 9 9 9 9 9 7 7 5 9 9 9 5 9 4 9 14 15 15 19 9 9 7 9 9 9 9 14 18 21 22 9 9 9 5 
5 9 5 6 5 9 5 9 5 4 5 5 5 9 5 4 5 5 4 5 4 5 4 5 9 5 9 5 9 5 9 20 21 21 17 15 15 15 15 15 15 15 18 21 26 25 9 9 9 4 
5 9 5 9 5 9 5 9 9 9 9 9 5 9 9 9 9 9 9 9 9 9 9 4 9 5 9 5 9 4 6 23 24 16 21 21 21 21 21 21 21 21 21 26 25 9 9 9 6 4 
5 9 4 9 5 6 5 9 5 5 5 4 5 9 5 5 4 5 5 5 5 4 5 4 9 5 9 5 9 5 2 1 7 23 24 24 24 24 24 24 24 24 24 25 6 9 9 9 9 5 
5 9 5 9 9 9 5 9 9 9 7 9 9 9 5 9 5 9 9 9 9 9 6 9 9 5 9 9 9 5 1 2 6 7 2 8 9 9 9 9 9 6 9 9 9 9 9 5 9 5 
4 9 5 7 1 5 5 5 5 5 5 5 5 9 5 9 5 4 4 5 5 5 9 5 9 5 9 5 9 5 5 4 4 5 5 5 5 4 4 5 5 5 4 4 5 5 5 5 9 5 
4 9 5 7 9 9 9 9 9 9 9 9 9 6 9 9 5 6 6 8 9 9 9 4 9 9 9 5 9 9 8 9 9 9 9 6 6 9 9 9 9 9 9 9 8 9 6 9 9 4 
5 4 5 5 5 5 4 4 5 5 5 5 5 9 5 9 9 9 9 9 8 9 7 5 9 4 9 4 5 5 5 5 5 9 5 5 5 5 5 5 5 5 5 5 5 9 5 5 5 5 
5 9 9 9 9 9 9 9 9 9 9 9 9 9 5 9 9 9 8 9 9 9 9 5 9 5 9 9 9 9 9 9 9 9 5 3 2 9 9 9 9 9 9 9 9 9 9 9 3 4 
5 9 5 5 5 5 5 5 5 5 5 5 5 5 5 4 4 9 9 9 9 9 9 5 9 5 5 4 5 5 5 5 5 5 5 5 4 4 5 5 4 5 4 5 5 9 5 4 5 5 
5 9 14 15 15 15 15 15 15 15 15 15 15 15 15 19 4 4 4 9 4 5 5 4 9 6 9 9 9 9 6 9 9 9 9 9 9 9 9 9 9 9 9 9 5 9 9 9 3 5 
4 9 23 24 24 24 24 24 24 24 24 24 24 24 16 22 7 9 5 9 5 9 9 4 9 5 5 4 5 5 4 5 5 5 5 5 5 5 4 4 4 4 4 5 5 9 5 4 5 5 
4 9 8 7 9 9 6 9 9 9 7 9 9 6 20 22 5 9 5 7 5 8 5 4 9 5 9 9 9 9 9 9 9 9 9 9 8 9 9 9 9 9 9 9 5 9 9 5 0 5 
5 14 15 15 15 15 15 15 15 15 15 15 19 9 20 22 5 9 5 9 5 9 9 4 4 5 7 5 5 5 9 9 9 9 9 9 9 9 9 9 9 7 9 9 5 9 9 5 0 5 
5 20 26 24 24 24 24 24 24 24 24 24 25 9 20 22 5 9 5 9 5 5 8 5 9 5 9 5 9 5 9 9 9 3 12 11 11 11 11 11 11 13 9 9 5 7 5 5 9 4 
5 20 22 9 9 9 7 9 9 9 6 9 8 7 20 22 5 7 5 9 5 9 9 5 9 5 9 5 7 5 9 9 6 9 9 9 9 9 9 9 9 9 9 8 5 9 5 6 9 5 
5 20 22 9 14 15 15 15 15 15 15 15 15 15 18 22 5 9 9 7 4 9 9 6 9 5 9 5 9 5 9 9 9 9 12 11 11 11 11 11 11 13 1 9 5 9 5 3 9 5 
4 20 22 6 23 24 24 24 24 24 24 24 24 24 16 22 5 9 4 9 4 4 4 9 9 5 9 5 9 8 9 9 9 9 9 7 9 9 9 9 9 9 6 6 5 9 5 0 9 5 
5 20 22 9 9 7 9 8 9 9 6 9 7 9 20 22 9 9 4 9 9 9 7 9 7 9 9 5 9 9 9 9 9 3 12 11 11 11 11 11 11 13 6 9 5 6 5 9 3 5 
5 20 17 15 15 15 15 15 15 15 15 15 15 15 18 22 5 9 4 9 9 9 5 5 9 5 9 5 6 6 9 9 7 9 9 9 9 9 9 9 8 9 9 9 5 9 5 9 9 5 
5 23 24 24 24 24 24 24 24 24 24 24 24 24 24 25 5 9 4 4 4 9 9 5 9 5 9 5 9 9 9 9 9 9 12 11 11 11 11 11 11 13 1 9 5 9 5 9 9 5 
5 5 5 5 5 5 4 5 5 5 4 5 5 5 5 5 5 9 9 4 9 9 9 5 9 5 9 5 9 9 6 6 9 9 8 9 9 9 9 9 9 9 9 9 5 9 5 3 0 4 
4 9 8 7 9 9 9 9 9 7 9 9 9 9 8 9 9 9 9 4 6 9 5 5 9 5 9 5 4 5 4 5 5 5 5 5 5 4 4 5 5 5 5 4 4 9 5 5 5 5 
4 9 4 4 4 4 4 4 4 4 4 4 4 4 4 4 4 5 9 9 9 9 5 9 9 7 6 9 9 9 9 9 9 7 9 9 9 7 9 9 8 9 9 9 9 8 9 9 9 4 
5 9 4 9 6 9 9 9 6 9 5 9 9 9 6 6 9 5 5 5 5 5 5 9 5 5 5 5 5 5 5 5 5 4 5 5 5 4 5 5 4 9 5 4 5 9 5 5 5 5 
5 9 4 9 5 9 5 5 9 5 5 4 4 4 9 9 9 9 9 9 8 9 7 9 9 9 8 9 9 9 7 9 9 9 9 7 9 9 9 9 5 9 5 9 9 7 7 9 9 5 
5 8 4 9 5 9 5 9 9 9 6 9 9 4 9 4 5 5 5 5 5 5 5 9 5 5 5 5 5 5 9 5 5 4 5 5 5 4 5 7 5 9 5 5 4 5 5 5 9 5 
4 8 4 5 5 9 5 5 5 5 5 5 9 9 9 5 1 3 7 9 9 1 5 9 9 9 9 9 9 8 9 5 9 8 9 7 1 6 5 9 4 8 6 9 9 6 6 5 9 5 
4 9 4 9 7 9 8 9 6 9 9 5 5 5 6 5 9 6 9 9 9 3 5 7 14 15 15 15 19 9 6 4 2 12 11 11 13 9 5 9 5 9 5 9 5 4 5 5 9 5 
5 9 4 9 4 4 4 4 4 4 9 6 9 5 9 5 3 9 9 9 6 6 5 1 23 24 24 24 25 9 9 5 1 12 11 11 13 9 5 9 5 9 5 9 9 6 9 6 9 5 
5 9 4 9 4 9 9 8 8 4 5 5 9 5 9 5 5 5 5 6 6 7 5 3 3 6 6 9 9 9 9 5 6 7 9 6 9 8 9 9 9 9 4 5 4 5 5 5 5 4 
5 9 4 9 4 4 4 4 9 4 9 5 9 5 9 9 9 9 5 9 7 6 5 5 5 5 5 5 5 8 5 4 5 5 5 4 5 5 4 5 5 9 5 7 9 9 9 9 8 4 
5 9 4 9 5 6 6 4 6 5 5 5 9 5 5 5 5 9 5 9 9 8 9 9 9 8 9 9 9 9 5 7 9 9 9 0 2 9 9 6 9 8 4 4 4 4 4 4 4 5 
4 9 4 9 5 6 7 9 6 5 9 9 8 9 3 3 5 8 5 5 5 5 5 5 5 5 5 9 9 9 5 2 12 11 11 13 8 12 11 13 9 9 4 9 9 8 9 9 9 5 
5 7 4 9 5 5 5 4 9 5 9 7 8 9 0 3 5 9 9 9 6 9 5 9 9 8 5 9 5 5 5 1 12 11 11 13 9 12 11 13 9 9 4 5 5 5 5 5 9 5 
5 9 4 9 8 9 9 9 9 5 9 9 9 9 9 0 5 9 5 5 5 9 5 9 5 9 5 9 5 6 5 0 6 6 7 9 9 9 9 9 9 7 9 9 9 9 8 5 9 5
5 9 4 4 4 4 4 4 9 5 2 6 9 9 9 6 5 9 5 9 5 9 5 9 5 9 5 9 5 6 5 5 5 5 5 5 5 9 4 4 7 9 4 5 5 5 9 5 9 5 
5 9 9 9 9 9 8 9 7 5 1 2 9 7 6 1 5 9 5 9 5 7 8 9 5 9 9 9 9 8 5 9 9 9 7 9 9 9 8 9 9 9 4 9 9 9 9 9 9 5 
4 5 5 5 5 5 5 5 5 5 5 5 4 5 5 5 4 4 4 4 5 5 5 5 5 5 4 5 4 5 5 4 5 5 5 5 5 5 5 5 5 4 4 5 5 5 5 5 5 4 
